0000000000000000000000000
0101010101010101010101010
0000000000000000000000000
0101010101010101010101010
0101010101010001010101010
0101010101010101010101010
0101010101010101010101010
0101010101010101010101010
0101010101010101010101010
0101010101010101010101010
0101010101010101010101010
0101010101010101010101010
0101010101010101010101010
0101010101010101010101010
0101010101010101010101010
0101010101010101010101010