0000000000000000000000000
0032323232323232323232323
0222222222222222222222222
2222222222222222222222220
2222222220000002222222000
2222220000000000000000000
2022000000002222222220000
2000220222222222220000000
2000002200000000000000000
2000002222222220000000000
2022222222220000000000000
2000000000002200000000000
2000000000000022000000000
2022222222220000220000000
2222222222222200002200030
2322222222222222222022230
2323232323222222222322222
2222222222222222222222222
2222222222222222222222222