88888888888888888888
00000000000000000000
00000000000000000000
00222222222222222222
22222222200000022222
22222200000000000000
20220000000022222222
20002202222222222200
20001022000000000000
20000022222222200000
20222222222200000000
20000000000022000000
20000000000000220000
20222222222200002200
22222222222222000022
23222222222222222220
00000000000000000000
00000000000000000000
00000000000000000000
00000000000000000000