0000000000000000000000000
0303030303030303030303030
0300000000000000011000030
0300000000000000000110030
0000000000000000000001100
2222000000000000000000011
1122000000000000000000000
0011220000000000000000000
0000112200000000000000000
0000001122000000000000000
0000000011220000000000000
0000000000112200000000000
0000000000001122000000000
0000000000000011220000000
0000000000000000112200030
0300000000000000001122230
0303030303030303030303030
0303030303030303030303030
0303030303030303030303030