0000000000000000000000000
0223030303030303030303030
0022220000000000011000030
2320020000000000000110030
2220220000000000000001100
2222220000000000000000011
2122000000000000000000000
2011220000000000000000000
2000112200000000000000000
2000001122000000000000000
2000000011220000000000000
2000000000112200000000000
2000000000001122000000000
2000000000000011220000000
2000000000000000112200030
2300000000000000001122230
2303030303030303030303030
2303030303030303030303030
2303030303030303030303030