8888888888888888888888888
0000000000000000000000000
0000000000000000000000000
0022222222222222222222200
2222222220000002222222000
2222220000000000000000000
2022000000002222222220000
2000220222222222220000000
2000102200000000000000000
2000002222222220000000000
2022222222220000000000000
2000000000002200000002000
2000000000000022000000000
2022222222220000220000000
2222222222222200002200030
2322222222222222222022230
2323232323222222222322222
0000000000000000000000000
0000000000000000000000000